-------------------------
-------------------------
-------------------------
-------------------------
-------------------------
-------------------------
-------------------------
-------------------------
-----------;+;-----------
;;;;;;;;;;;;+;;;;;;;;;;;;
^
|||||||||||||||||||||||||
|.......................|
|.......................|
||||||||||||||||||||||/||
|.......................|
|...................m.m.|
|.......................|
|.........||/||.........|
|||||||||||...|||||||||||
.........................