|||||||||||||||||||||||||
|-----------------------|
|-----------------------|
|-~~~~~~~~~~~~~~~~~~~~~-|
|-----------------------|
|-~~~~~~~~~~~~~~~~~~~~~-|
|-----------------------|
|-~~~~~~~~~~~~~~~~~~~~~-|
|-----------------------|
||||||||||||||||||||||/||