-------------------------
-------------------------
-------------------------
-------------------------
-------------------------
-------------------------
-------------------------
-------------------------
-------------------------
-------------------------
-------------------------
-------------------------
-------------------------
-------------------------
-------------------------
-------------------------
-------------------------
-------------------------
-------------------------
-------------------------
-------------------------
-------------------------
-------------------------
-------------------------
-------------------------
^
|||||||||||||||||||||||||
|.......................|
|.......................|
|.......................|
|.......................|
|.......................|
|.......................|
|.......................|
|.......................|
|.......................|
|.......................|
|.......................|
|.......................|
|.......................|
|.......................|
|.......................|
|.......................|
|.......................|
|.......................|
|.......................|
|.......................|
|.......................|
|.......................|
|.......................|
|||||||||||||||||||||||||