|||||||||||||||||||||||||
|-----------------------|
|-~~~~~~~~~~~~~~~~~~~~~-|
|-----------------------|
|-~~~~~~~~~~~~~~~~~~~~~-|
|-----------------------|
|-~~~~~~~~~~~~~~~~~~~~~-|
|-----------------------|
|-~~~~~~~~~~~~~~~~~~~~~-|
|-----------------------|
|-~~~~~~~~~~~~~~~~~~~~~-|
|-----------------------|
|-~~~~~~~~~~~~~~~~~~~~~-|
|-----------------------|
|-~~~~~~~~~~~~~~~~~~~~~-|
|-----------------------|
|-~~~~~~~~~~~~~~~~~~~~~-|
|-----------------------|
|-~~~~~~~~~~~~~~~~~~~~~-|
|-----------------------|
|-~~~~~~~~~~~~~~~~~~~~~-|
|-----------------------|
|-~~~~~~~~~~~~~~~~~~~~~-|
|-----------------------|
||||||||||||||||//////|||