----------------------------------------
----------------------------------------
----------------------------------------
----------------------------------------
----------------------------------------
----------------------------------------
----------------------------------------
----------------------------------------
----------------------------------------
----------------------------------------
----------------------------------------
----------------------------------------
----------------------------------------
----------------------------------------
----------------------------------------
----------------------------------------
----------------------------------------
----------------------------------------
----------------------------------------
----------------------------------------
----------------------------------------
----------------------------------------
----------------------------------------
----------------------------------------
----------------------------------------
----------------------------------------
----------------------------------------
----------------------------------------
----------------------------------------
----------------------------------------
----------------------------------------
----------------------------------------
----------------------------------------
----------------------------------------
----------------------------------------
----------------------------------------
----------------------------------------
----------------------------------------
----------------------------------------
----------------------------------------
^
||||||||||||||||||||||||||||||||||||||||
|......................................|
|......................................|
|......................................|
|......................................|
|......................................|
|......................................|
|......................................|
|......................................|
|......................................|
|......................................|
|......................................|
|......................................|
|......................................|
|......................................|
|......................................|
|......................................|
|......................................|
|......................................|
|......................................|
|......................................|
|......................................|
|......................................|
|......................................|
|......................................|
|......................................|
|......................................|
|......................................|
|......................................|
|......................................|
|......................................|
|......................................|
|......................................|
|......................................|
|......................................|
|......................................|
|......................................|
|......................................|
|......................................|
||||||||||||||||||||||||||||||||||||||||