----------
----------
----------
----------
----------
----------
----------
----------
----------
----------
^
||||||||||
|........|
|........|
|........|
|........|
|........|
|........|
|........|
|........|
||||||/|||