----------
----------
----------
----------
----------
----------
----------
----------
----------
------/---
^
||||||||||
|........|
|........|
|........|
|........|
|........|
|........|
|........|
|........|
||||||.|||