----------
----------
----------
----------
----------
----------
----------
----------
----------
----------
^
||||||||||
|........|
||||||||.|
|........|
|.||||||||
|........|
||||||||.|
|........|
|.||||||||
|.||||||||