||||||||||
|--------|
|--------|
|||||||/||
|--------|
|-~~~~~--|
|--------|
|-~~~~~--|
|--------|
|||||||/||